#############
e..#.#...#..#
##.#.##.##.##
#....#..#...x
###.##.##.###
#...........#
###...###.###
#...........#
#############
