#############
e..#.#...#..#
##.#.##.##.##
#....#..#...#
###.##.##.###
#...........#
#####.###.###
#...........#
#.###########
#.###########
#.#.#...#..##
#..#.##.##.##
#....#..#...#
###.##.#..###
#...........x
#####.###.###
#...........#
#############
