#############
e..#.#...#..#
##.#.##.##.##
#....#..#...x
###.##.##.###
#...........#
#####.s##.###
#...........#
#############
